23,09,23,23,23,23,23,23,23,23,23,23,23,23,23,23,23,23,23,23,09,09,09,09,23,23,23,23,23,23,23,23
23,23,23,23,23,23,23,23,23,23,23,18,11,12,23,23,23,23,23,09,09,09,09,09,23,23,09,23,23,23,23,23
23,23,23,23,23,23,18,11,11,11,11,22,10,13,23,23,23,23,23,09,09,09,09,09,09,23,23,23,23,23,23,23
11,11,11,11,11,11,22,10,10,10,10,10,10,13,23,23,23,23,23,23,08,00,00,01,09,23,23,23,23,23,23,23
10,10,10,10,10,10,10,10,10,20,15,15,21,19,12,23,23,23,23,23,06,00,00,00,02,23,09,23,24,23,23,23
10,10,10,10,10,10,10,10,10,13,09,09,17,10,13,23,23,23,23,09,09,05,05,00,00,03,23,23,23,23,23,23
10,10,10,10,20,15,15,15,15,14,23,23,17,10,13,23,23,23,23,09,09,09,09,05,05,04,23,23,23,23,23,23
15,15,15,15,14,23,23,23,23,23,23,23,17,10,13,23,23,23,09,09,09,09,09,09,23,23,23,23,23,23,23,23
23,23,23,23,23,23,23,23,23,23,09,09,17,10,13,23,23,24,23,09,09,01,01,02,23,23,23,23,23,23,23,23
09,09,09,09,09,09,09,09,09,09,09,09,17,10,13,09,09,09,09,09,08,00,00,03,23,23,23,24,23,23,23,23
09,09,09,09,09,09,09,24,09,23,09,23,17,10,13,09,09,24,09,09,07,00,00,03,23,23,23,23,23,23,23,23
09,01,01,01,02,09,09,23,23,23,23,23,17,10,13,09,09,09,09,09,07,00,00,03,24,23,23,23,23,23,23,23
08,00,00,00,03,09,23,23,23,23,23,23,17,10,13,09,09,09,09,09,07,00,00,03,23,23,23,23,23,23,23,23
07,00,05,05,04,23,23,23,09,09,09,09,17,10,13,09,09,09,09,09,09,06,00,23,23,23,23,23,23,23,23,23
06,09,09,23,24,23,09,09,09,09,09,09,17,10,13,09,09,09,09,09,09,23,05,23,23,23,23,23,23,23,23,23
09,09,09,09,23,09,09,09,09,09,09,09,17,10,13,24,09,09,09,09,09,09,23,23,23,24,23,23,23,23,23,23
09,09,09,09,09,09,09,09,09,18,11,12,17,10,13,09,09,09,09,09,24,23,23,23,23,23,23,23,23,23,23,23
09,09,09,09,09,09,09,09,09,17,10,13,17,10,13,09,09,09,09,09,09,23,23,23,23,23,23,23,23,23,23,23
09,09,09,09,09,09,09,09,18,22,10,19,22,10,13,09,09,09,09,09,09,23,23,23,23,23,23,23,23,23,23,23
09,09,09,09,09,09,09,09,17,10,10,10,20,15,14,09,09,09,09,09,09,23,09,09,01,01,01,01,01,23,23,23
09,24,09,09,08,02,09,09,16,21,10,10,13,09,09,09,09,09,09,09,23,07,00,00,00,00,00,00,00,02,23,23
09,09,09,07,00,03,09,09,09,16,15,15,14,09,09,09,09,09,09,09,23,06,00,00,00,00,00,00,00,00,23,23
09,09,09,06,00,03,09,09,09,09,09,09,09,09,23,09,09,09,09,23,23,23,23,23,06,05,05,05,05,05,23,23
09,09,09,05,05,04,09,09,09,09,09,09,09,23,23,24,24,23,23,23,23,23,23,23,23,09,23,23,23,23,23,23
09,07,00,02,23,24,09,09,09,09,09,09,09,23,23,23,23,23,23,23,23,23,23,23,23,23,23,23,24,23,23,23
09,00,00,03,23,23,09,09,09,09,09,09,09,23,23,23,23,23,23,23,23,23,23,23,23,23,23,23,23,23,23,23
07,00,04,09,09,23,23,09,09,09,09,09,09,09,09,09,09,23,23,23,23,24,23,23,23,23,23,23,23,23,23,23
06,05,09,09,09,09,09,09,09,09,09,09,09,09,09,09,09,23,23,23,23,23,23,23,23,23,23,23,23,23,23,23
09,09,09,09,09,09,09,09,09,09,09,09,09,09,09,09,09,09,23,23,23,23,23,23,23,23,23,23,23,23,23,09
09,09,09,09,09,09,09,09,09,09,09,09,09,09,09,09,09,09,09,09,23,23,23,23,23,23,23,23,23,23,23,23
09,09,09,09,09,09,09,09,09,09,09,09,09,09,09,09,09,09,09,09,23,23,23,23,23,23,23,23,23,23,23,23
09,09,09,09,09,09,09,09,09,09,09,09,09,09,09,09,09,09,09,09,09,09,09,09,23,23,23,23,23,23,09,09

00,00,00,00,00,00,00,00,00,00,00,00,00,00,00,00,00,00,00,00,00,00,00,00,00,00,00,00,00,00,00,00
00,00,00,00,00,00,00,00,00,00,00,26,27,28,00,00,00,00,00,00,00,00,00,00,00,00,00,00,00,00,00,00
00,00,00,00,00,00,26,27,27,27,27,25,00,29,00,00,00,00,00,00,00,00,00,00,00,00,00,00,00,00,00,00
27,27,27,27,27,27,25,00,00,00,00,00,00,29,00,00,00,00,00,00,00,00,00,00,00,00,00,00,00,00,00,00
00,00,00,00,00,00,00,00,00,25,31,31,25,25,28,00,00,00,00,00,00,00,00,00,00,00,00,00,00,00,00,00
00,00,00,00,00,00,00,00,00,29,00,00,33,00,29,00,00,00,00,00,00,00,00,00,00,00,00,00,00,00,00,00
00,00,00,00,25,31,31,31,31,30,00,00,33,00,29,00,00,00,00,00,00,00,00,00,00,00,00,00,00,00,00,00
31,31,31,31,30,00,00,00,00,00,00,00,33,00,29,00,00,00,00,00,00,00,00,00,00,00,00,00,00,00,00,00
00,00,00,00,00,00,00,00,00,00,00,00,33,00,29,00,00,00,00,00,00,00,00,00,00,00,00,00,00,00,00,00
00,00,00,00,00,00,00,00,00,00,00,00,33,00,29,00,00,00,00,00,00,00,00,00,00,00,00,00,00,00,00,00
00,00,00,00,00,00,00,00,00,00,00,00,33,00,29,00,00,00,00,00,00,00,00,00,00,00,00,00,00,00,00,00
00,00,00,00,00,00,00,00,00,00,00,00,33,00,29,00,00,00,00,00,00,00,00,00,00,00,00,00,00,00,00,00
00,00,00,00,00,00,00,00,00,00,00,00,33,00,29,00,00,00,00,00,00,00,00,00,00,00,00,00,00,00,00,00
00,00,00,00,00,00,00,00,00,00,00,00,33,00,29,00,00,00,00,00,00,00,00,00,00,00,00,00,00,00,00,00
00,00,00,00,00,00,00,00,00,00,00,00,33,00,29,00,00,00,00,00,00,00,00,00,00,00,00,00,00,00,00,00
00,00,00,00,00,00,00,00,00,00,00,00,33,00,29,00,00,00,00,00,00,00,00,00,00,00,00,00,00,00,00,00
00,00,00,00,00,00,00,00,00,26,27,28,33,00,29,00,00,00,00,00,00,00,00,00,00,00,00,00,00,00,00,00
00,00,00,00,00,00,00,00,00,33,00,29,33,00,29,00,00,00,00,00,00,00,00,00,00,00,00,00,00,00,00,00
00,00,00,00,00,00,00,00,26,25,00,25,25,00,29,00,00,00,00,00,00,00,00,00,00,00,00,00,00,00,00,00
00,00,00,00,00,00,00,00,33,00,00,00,25,31,30,00,00,00,00,00,00,00,00,00,00,00,00,00,00,00,00,00
00,00,00,00,00,00,00,00,32,25,00,00,29,00,00,00,00,00,00,00,00,00,00,00,00,00,00,00,00,00,00,00
00,00,00,00,00,00,00,00,00,32,31,31,30,00,00,00,00,00,00,00,00,00,00,00,00,00,00,00,00,00,00,00
00,00,00,00,00,00,00,00,00,00,00,00,00,00,00,00,00,00,00,00,00,00,00,00,00,00,00,00,00,00,00,00
00,00,00,00,00,00,00,00,00,00,00,00,00,00,00,00,00,00,00,00,00,00,00,00,00,00,00,00,00,00,00,00
00,00,00,00,00,00,00,00,00,00,00,00,00,00,00,00,00,00,00,00,00,00,00,00,00,00,00,00,00,00,00,00
00,00,00,00,00,00,00,00,00,00,00,00,00,00,00,00,00,00,00,00,00,00,00,00,00,00,00,00,00,00,00,00
00,00,00,00,00,00,00,00,00,00,00,00,00,00,00,00,00,00,00,00,00,00,00,00,00,00,00,00,00,00,00,00
00,00,00,00,00,00,00,00,00,00,00,00,00,00,00,00,00,00,00,00,00,00,00,00,00,00,00,00,00,00,00,00
00,00,00,00,00,00,00,00,00,00,00,00,00,00,00,00,00,00,00,00,00,00,00,00,00,00,00,00,00,00,00,00
00,00,00,00,00,00,00,00,00,00,00,00,00,00,00,00,00,00,00,00,00,00,00,00,00,00,00,00,00,00,00,00
00,00,00,00,00,00,00,00,00,00,00,00,00,00,00,00,00,00,00,00,00,00,00,00,00,00,00,00,00,00,00,00
00,00,00,00,00,00,00,00,00,00,00,00,00,00,00,00,00,00,00,00,00,00,00,00,00,00,00,00,00,00,00,00

00,00,00,00,00,00,00,00,00,00,00,00,00,00,00,00,00,00,00,00,00,00,00,00,00,00,00,00,00,00,00,00
00,00,00,00,00,00,00,00,00,00,00,00,00,00,00,00,00,34,00,00,00,00,00,00,00,00,00,00,00,00,00,00
00,00,00,00,00,00,00,00,00,00,00,00,00,00,00,00,00,00,34,00,00,00,00,00,00,00,00,00,00,00,00,00
00,00,00,00,00,00,00,00,00,00,00,00,00,00,00,00,00,00,00,00,00,00,00,00,00,00,00,00,00,00,00,00
00,00,00,00,00,00,00,00,00,00,00,00,00,00,00,00,00,00,00,00,00,00,00,00,00,00,00,00,00,00,00,00
00,00,00,00,00,00,00,00,00,00,00,00,00,00,00,00,00,00,00,00,00,00,00,00,00,00,00,00,00,00,00,00
00,00,00,00,00,00,00,00,00,00,00,00,00,00,00,00,00,00,00,00,00,00,00,00,00,00,00,00,00,00,00,00
00,00,00,00,00,00,00,00,00,00,00,00,00,00,00,00,00,00,00,00,00,00,00,34,00,00,00,00,00,00,00,00
00,00,00,00,00,00,00,00,00,00,00,00,00,00,00,00,00,00,00,00,00,00,00,00,00,00,00,00,00,00,00,00
00,00,00,00,00,00,00,00,00,00,00,00,00,00,00,00,00,00,00,00,00,00,00,00,00,00,00,00,00,00,00,00
00,00,00,00,00,00,00,00,00,00,00,00,00,00,00,00,00,00,00,00,00,00,00,00,00,00,00,00,00,00,00,00
00,00,00,00,00,00,00,00,00,00,00,00,00,00,00,00,00,00,00,00,00,00,00,00,00,00,00,00,00,00,00,00
00,00,00,00,00,00,00,00,00,00,00,00,00,00,00,00,00,00,00,00,00,00,00,00,00,00,00,00,00,00,00,00
00,00,00,00,00,00,00,00,00,00,00,00,00,00,00,00,00,00,00,00,00,00,00,00,00,00,00,00,00,00,00,00
00,00,00,00,00,00,00,00,00,00,00,00,00,00,00,00,00,00,00,00,00,00,00,00,00,00,00,00,00,00,00,00
00,00,00,00,00,00,00,00,00,00,00,00,00,00,00,00,00,00,00,00,00,00,00,00,00,00,00,00,00,00,00,00
00,00,00,00,00,00,00,00,00,00,00,00,00,00,00,00,00,00,00,00,00,00,00,00,00,00,00,35,00,00,00,00
00,00,00,34,00,00,00,00,00,00,00,00,00,00,00,00,00,00,00,00,00,00,00,00,00,00,00,00,00,00,00,00
00,00,00,00,00,00,00,00,00,00,00,00,00,00,00,00,00,00,00,00,00,35,00,00,00,00,00,00,00,00,00,00
00,00,00,00,00,00,00,00,00,00,00,00,00,00,00,00,00,00,00,00,00,00,00,00,00,00,00,00,00,00,00,00
00,00,00,00,00,00,00,00,00,00,00,00,00,00,00,00,00,00,00,00,00,00,00,00,00,00,00,00,00,00,00,00
00,35,00,00,00,00,00,00,00,00,00,00,00,00,00,00,00,00,00,00,00,00,00,00,00,00,00,00,00,00,00,00
00,00,00,00,00,00,00,00,00,00,00,00,00,00,00,00,00,00,00,00,00,00,00,00,00,00,00,00,00,00,00,00
00,00,00,00,00,00,00,00,00,00,00,00,00,00,00,00,00,00,00,00,00,00,00,00,00,00,00,00,00,34,00,00
00,00,00,00,00,00,00,00,00,00,00,00,00,00,00,00,00,00,00,00,00,00,00,00,00,00,00,00,00,00,00,00
00,00,00,00,00,00,00,00,00,00,00,00,35,00,00,00,00,00,00,00,00,00,00,00,00,00,00,00,00,00,00,00
00,00,00,00,00,35,00,00,00,00,00,00,00,00,00,00,00,00,00,00,00,00,00,00,00,00,00,00,34,00,00,00
00,00,00,00,00,00,00,00,00,00,00,00,00,35,00,00,00,00,00,00,00,00,00,00,00,00,00,00,00,00,00,00
00,00,00,00,00,00,00,00,35,00,00,00,00,00,00,00,00,00,00,00,00,00,00,00,34,00,00,00,00,00,00,00
00,00,00,00,00,00,00,00,00,00,00,00,00,00,00,00,00,00,00,00,00,00,00,00,00,00,00,00,00,00,00,00
00,00,00,35,00,00,00,00,00,00,00,00,00,00,00,00,00,00,00,00,00,00,00,00,00,00,00,00,00,00,00,00
00,00,00,00,00,00,00,00,00,00,00,00,00,00,00,00,00,00,00,00,00,00,00,00,00,00,00,00,00,00,00,00